{
  "alameda-areeiro-gulbenkian": [
    2828082,
    2828083,
    2828086,
    2828101,
    2828113,
    2828129,
    2828438,
    2828439,
    2828444,
    2828445,
    2828473,
    2828480,
    2828490,
    2828533,
    2828707,
    2828851,
    2828861,
    2828864,
    2828877,
    2828886,
    2828895,
    2828904,
    2828906,
    2828908,
    2828910,
    2828959,
    2828972,
    2828973,
    2828996,
    2829020,
    2829022,
    2829042,
    2829046,
    2829047,
    2829471,
    2829487,
    2830168,
    2830215,
    2830216,
    2830221,
    2830997,
    2831009,
    2831023,
    2831039,
    2831042,
    2831197,
    2831205,
    2831335,
    2831339,
    2831345,
    2831432,
    2831456
  ],
  "campo-grande-alvalade": [
    2828091,
    2828098,
    2828103,
    2828105,
    2828925,
    2828930,
    2828933,
    2828941,
    2829440,
    2830123,
    2830229,
    2830867,
    2830868,
    2830890,
    2830893,
    2830907,
    2830912,
    2830921,
    2830941,
    2830942,
    2830944,
    2831192,
    2831202,
    2831206,
    2831216,
    2831220,
    2831222,
    2831245,
    2831247,
    2831337,
    2831351,
    2831367,
    2831368
  ],
  "arroios-penha-franca": [
    2828504,
    2828511,
    2828522,
    2828524,
    2828543,
    2828546,
    2828663,
    2828720,
    2828723,
    2828726,
    2828730,
    2828734,
    2828744,
    2828745,
    2828752,
    2828762,
    2828770,
    2830088,
    2830116,
    2831043
  ]
}